12121212121212121212
12121263636363121212
12121263636363121212
12121261626162121212
12121261616161121212
12121261616161121212
12121261616161121212
12121212616112121212
12121212121212121212
12121212121212121212
