12121212121212121212
12121212121212121212
12121212121212121212
12737474747474747474
12760202020202020202
12760202020202020202
12798080808080808080
12060606060606060606
12060606060606060606
12060606060606060606
