01010101010101010101
41414141414141414141
51747474747474747474
51020202020202020202
51026002020202020202
51606060020202020202
51020202020202020202
51020202020202020202
51020202020202020202
51515151515151515151
