06060606060606100606
06060606060606100606
06060606060606100606
05050505050505090505
51020202020202020251
51020202020202020251
51020202020202020251
38383838383838383838
01010101010101010101
01010101010101010101
