12121212121212121212
12121212121212121212
12121212121212121212
74747474747474747512
02020202020255567812
02020202020258597812
80808080808080808112
06060606060606060612
06060606060606060612
06060606060606060612
