01010101010101010101
41414141414141410101
74747474747474754001
02026363630202784001
02026312630202784001
02020202020202784001
02020202020202784001
02020202020202784001
02020202020202783941
51515151515102515151
