12121212121212121212
12121212121212121212
12121212121212121212
74747474747474747474
02020202020202020202
02020202020202020202
80808080808080118080
06060606060606100606
06060606060606100606
06060606060606100606
